5 10
---x------
--*-------
xx-x------
xx-x------
xx-x--x$--